{
  "map4x2": [
    [1, 1, 1, 1],
    [1, 1, 1, 1]
  ],
  "map4x3": [
    [1, 1, 1, 1],
    [1, 1, 1, 1],
    [1, 1, 1, 1]
  ],

  "map2x4": [
    [1, 1],
    [1, 1],
    [1, 1],
    [1, 1]
  ],

  "map000": [
    [1, 1, 1, 1, 1, 1, 1, 1, 1, 1, 1, 1, 1],
    [1, 1, 1, 1, 1, 1, 1, 1, 1, 1, 1, 1, 1],
    [1, 1, 1, 1, 1, 1, 1, 1, 1, 1, 1, 1, 1],
    [1, 1, 1, 1, 1, 1, 1, 1, 1, 1, 1, 1, 1],
    [1, 1, 1, 1, 1, 1, 1, 1, 1, 1, 1, 1, 1],
    [1, 1, 1, 1, 1, 1, 1, 1, 1, 1, 1, 1, 1],
    [1, 1, 1, 1, 1, 1, 1, 1, 1, 1, 1, 1, 1],
    [1, 1, 1, 1, 1, 1, 1, 1, 1, 1, 1, 1, 1],
    [1, 1, 1, 1, 1, 1, 1, 1, 1, 1, 1, 1, 1],
    [1, 1, 1, 1, 1, 1, 1, 1, 1, 1, 1, 1, 1]
  ],

  "map00": [[1], [1], [1], [1], [1], [1], [1], [1], [1], [1], [1], [1], [1]],

  "map0": [
    [1, 1, 1, 1],
    [1, 1, 1, 1],
    [1, 1, 1, 1]
  ],

  "map1": [
    [0, 1, 1, 0, 1, 0],
    [1, 1, 1, 0, 1, 1],
    [1, 1, 0, 0, 1, 1],
    [1, 1, 0, 0, 1, 1],
    [1, 1, 1, 1, 1, 1],
    [0, 1, 1, 1, 1, 0]
  ],
  "map2": [
    [1, 1, 1, 1, 1, 0, 1, 1],
    [0, 1, 1, 1, 1, 0, 1, 1],
    [0, 1, 1, 1, 1, 1, 1, 0],
    [1, 1, 1, 0, 1, 0, 1, 1]
  ],
  "map3": [
    [1, 1, 1, 0, 1, 0, 1, 1, 1, 1],
    [1, 1, 1, 0, 1, 0, 1, 0, 0, 0],
    [1, 0, 0, 0, 1, 0, 1, 1, 1, 1],
    [1, 0, 1, 0, 1, 0, 1, 1, 0, 1],
    [1, 1, 1, 1, 1, 1, 1, 0, 1, 1],
    [1, 1, 1, 0, 1, 0, 1, 0, 1, 0],
    [1, 1, 1, 0, 1, 0, 1, 0, 0, 0]
  ],

  "map4": [
    [1, 1, 1, 1, 1, 1, 1, 1],
    [1, 1, 0, 1, 1, 0, 1, 0],
    [1, 1, 1, 1, 1, 1, 1, 1],
    [1, 1, 0, 1, 1, 0, 1, 1]
  ],

  "map5": {
    "map": [
    [1, 1, 1, 0, 1],
    [1, 0, 1, 1, 1],
    [1, 0, 0, 1, 0],
    [1, 1, 1, 1, 1],
    [0, 1, 1, 0, 1],
    [1, 1, 0, 0, 0]
  ],
  "spawns": {
    "player1":[0,0],
    "player2":[5,5],
    "player3":[0,6],
    "player4":[5,0]
  }
}
}
